hola|hello|Hello.wav|hallo|hallo.wav|bonjour|Hello.wav|ciao|Hello.wav
adios|goodbye|auf Wiedersehen|auf Wiedersehen.wav|au revoir|arrivederci
gracias|thank you|thankyou.wav|danke|danke.wav|merci|thankyou.wav|grazie|thankyou.wav
por favor|please|please.wav|bitte|bitte.wav|s'il vous plait|please.wav|per favore|please.wav
buenos dias|good morning|goodmorning.wav|guten Morgen|guten Morgen.wav|bonjour|goodmorning.wav|buongiorno|goodmorning.wav
buenas noches|good night|goodnight.wav|gute Nacht|gute Nacht.wav|bonne nuit|goodnight.wav|buonanotte|goodnight.wav
como estas|how are you|howareyou.wav|wie geht es dir|wie geht es dir.wav|comment ca va|howareyou.wav|come stai|howareyou.wav
bien|good|good.wav|gut|gut.wav|bien|good.wav|bene|good.wav
mal|bad|bad.wav|schlecht|schlecht.wav|mal|bad.wav|male|bad.wav
si|yes|yes.wav|ja|ja.wav|oui|yes.wav|si|yes.wav
no|no|no.wav|nein|nein.wav|non|no.wav|no|no.wav
amigo|friend|friend.wav|freund|freund.wav|ami|friend.wav|amico|friend.wav
familia|family|family.wav|familie|familie.wav|famille|family.wav|famiglia|family.wav
casa|house|house.wav|haus|haus.wav|maison|house.wav|casa|house.wav
escuela|school|school.wav|schule|schule.wav|ecole|school.wav|scuola|school.wav
trabajo|work|work.wav|arbeit|arbeit.wav|travail|work.wav|lavoro|work.wav
comida|food|food.wav|essen|essen.wav|nourriture|food.wav|cibo|food.wav
agua|water|water.wav|wasser|wasser.wav|eau|water.wav|acqua|water.wav
vino|wine|wine.wav|wein|wein.wav|vin|wine.wav|vino|wine.wav
cafe|coffee|coffee.wav|kaffee|kaffee.wav|cafe|coffee.wav|caffe|coffee.wav
te|tea|tea.wav|tee|tee.wav|the|tea.wav|te|tea.wav
leche|milk|milk.wav|milch|milch.wav|lait|milk.wav|latte|milk.wav
pan|bread|bread.wav|brot|brot.wav|pain|bread.wav|pane|bread.wav
mantequilla|butter|butter.wav|butter|buttera.wav|beurre|butter.wav|burro|butter.wav
queso|cheese|cheese.wav|kase|kase.wav|fromage|cheese.wav|formaggio|cheese.wav
manzana|apple|apple.wav|apfel|apfel.wav|pomme|apple.wav|mela|apple.wav
naranja|orange|orange.wav|orange|orangea.wav|orange|orange.wav|arancia|orange.wav
platano|banana|banana.wav|banane|banane.wav|banane|banana.wav|banana|banana.wav
uva|grape|grape.wav|traube|traube.wav|raisin|grape.wav|uva|grape.wav
limon|lemon|lemon.wav|zitrone|zitrone.wav|citron|lemon.wav|limone|lemon.wav
carne|meat|meat.wav|fleisch|fleisch.wav|viande|meat.wav|carne|meat.wav
pollo|chicken|chicken.wav|huhn|huhn.wav|poulet|chicken.wav|pollo|chicken.wav
tiburon|shark|shark.wav|hai|hai.wav|requin|shark.wav|squalo|shark.wav
verdura|vegetable|vegetable.wav|gemuse|gemuse.wav|legume|vegetable.wav|verdura|vegetable.wav
ensalada|salad|salad.wav|salat|salad.wav|salade|salad.wav|insalata|salad.wav
sopa|soup|soup.wav|suppe|suppe.wav|soupe|soup.wav|zuppa|soup.wav
postre|dessert|dessert.wav|nachtisch|nachtisch.wav|dessert|dessert.wav|dessert|dessert.wav
chocolate|chocolate|chocolate.wav|schokolade|schokolade.wav|chocolat|chocolate.wav|cioccolato|chocolate.wav
helado|icecream|icecream.wav|eis|eis.wav|glace|icecream.wav|gelato|icecream.wav
pastel|cake|cake.wav|kuchen|kuchen.wav|gateau|cake.wav|torta|cake.wav
gato|cat|cat.wav|katze|katze.wav|chat|cat.wav|gatto|cat.wav
perro|dog|dog.wav|hund|hund.wav|chien|dog.wav|cane|dog.wav
caballo|horse|horse.wav|pferd|pferd.wav|cheval|horse.wav|cavallo|horse.wav
vaca|cow|cow.wav|kuh|kuh.wav|vache|cow.wav|mucca|cow.wav
cerdo|pig|pig.wav|schwein|schwein.wav|cochon|pig.wav|maiale|pig.wav
oveja|sheep|sheep.wav|schaf|schaf.wav|mouton|sheep.wav|pecora|sheep.wav
raton|mouse|mouse.wav|maus|maus.wav|souris|mouse.wav|topo|mouse.wav
pajaro|bird|bird.wav|vogel|vogel.wav|oiseau|bird.wav|uccello|bird.wav
pez|fish|fish.wav|fisch|fisch.wav|poisson|fish.wav|pesce|fish.wav
serpiente|snake|snake.wav|schlange|schlange.wav|serpent|snake.wav|serpente|snake.wav
arbol|tree|tree.wav|baum|baum.wav|arbre|tree.wav|albero|tree.wav
flor|flower|flower.wav|blume|blume.wav|fleur|flower.wav|fiore|flower.wav
hierba|grass|grass.wav|gras|gras.wav|herbe|grass.wav|erba|grass.wav
hoja|leaf|leaf.wav|blatt|blatt.wav|feuille|leaf.wav|foglia|leaf.wav
raiz|root|root.wav|wurzel|wurzel.wav|racine|root.wav|radice|root.wav
rama|branch|branch.wav|zweig|zweig.wav|branche|branch.wav|ramo|branch.wav
cielo|sky|sky.wav|himmel|himmel.wav|ciel|sky.wav|cielo|sky.wav
sol|sun|sun.wav|sonne|sonne.wav|soleil|sun.wav|sole|sun.wav
luna|moon|moon.wav|mond|mond.wav|lune|moon.wav|luna|moon.wav
estrella|star|star.wav|stern|stern.wav|etoile|star.wav|stella|star.wav
mar|sea|sea.wav|meer|meer.wav|mer|sea.wav|mare|sea.wav
rio|river|river.wav|fluss|fluss.wav|riviere|river.wav|fiume|river.wav
lago|lake|lake.wav|see|see.wav|lac|lake.wav|lago|lake.wav
montana|mountain|mountain.wav|berg|berg.wav|montagne|mountain.wav|montagna|mountain.wav
bosque|forest|forest.wav|wald|wald.wav|foret|forest.wav|foresta|forest.wav
desierto|desert|desert.wav|wuste|wuste.wav|desert|desert.wav|deserto|desert.wav
isla|island|island.wav|insel|insel.wav|ile|island.wav|isola|island.wav
ciudad|city|city.wav|stadt|stadt.wav|ville|city.wav|citta|city.wav
pueblo|town|town.wav|dorf|dorf.wav|ville|town.wav|citta|town.wav
calle|street|street.wav|strasse|strasse.wav|rue|street.wav|strada|street.wav
camino|road|road.wav|weg|weg.wav|chemin|road.wav|strada|road.wav
puente|bridge|bridge.wav|brucke|brucke.wav|pont|bridge.wav|ponte|bridge.wav
plaza|square|square.wav|platz|platz.wav|place|square.wav|piazza|square.wav
parque|park|park.wav|park|parka.wav|parc|park.wav|parco|park.wav
camisa|shirt|shirt.wav|hemd|hemd.wav|chemise|shirt.wav|camicia|shirt.wav
hotel|hotel|hotel.wav|hotel|hotela.wav|hotel|hotel.wav|albergo|hotel.wav
restaurante|restaurant|restaurant.wav|restaurant|restauranta.wav|restaurant|restaurant.wav|ristorante|restaurant.wav
tienda|store|store.wav|laden|laden.wav|magasin|store.wav|negozio|store.wav
mercado|market|market.wav|markt|markt.wav|marche|market.wav|mercato|market.wav
instituto|institute|institute.wav|institut|institut.wav|lycee|institute.wav|istituto|institute.wav
universidad|university|university.wav|universitat|universitat.wav|universite|university.wav|universita|university.wav
biblioteca|library|library.wav|bibliothek|bibliothek.wav|bibliotheque|library.wav|biblioteca|library.wav
museo|museum|museum.wav|museum|museuma.wav|musee|museum.wav|museo|museum.wav
cine|cinema|cinema.wav|kino|kino.wav|cinema|cinema.wav|cinema|cinema.wav
teatro|theater|theater.wav|theater|theatera.wav|theatre|theater.wav|teatro|theater.wav
estadio|stadium|stadium.wav|stadion|stadion.wav|stade|stadium.wav|stadio|stadium.wav
iglesia|church|church.wav|kirche|kirche.wav|eglise|church.wav|chiesa|church.wav
templo|temple|temple.wav|tempel|tempel.wav|temple|temple.wav|tempio|temple.wav
mezquita|mosque|mosque.wav|moschee|moschee.wav|mosquee|mosque.wav|moschea|mosque.wav
sinagoga|synagogue|synagogue.wav|synagoge|synagoge.wav|synagogue|synagogue.wav|sinagoga|synagogue.wav
puerta|door|door.wav|tur|tur.wav|porte|door.wav|porta|door.wav
ventana|window|window.wav|fenster|fenster.wav|fenetre|window.wav|finestra|window.wav
mesa|table|table.wav|tisch|tisch.wav|table|table.wav|tavolo|table.wav
silla|chair|chair.wav|stuhl|stuhl.wav|chaise|chair.wav|sedia|chair.wav
cama|bed|bed.wav|bett|bett.wav|lit|bed.wav|letto|bed.wav
espejo|mirror|mirror.wav|spiegel|spiegel.wav|miroir|mirror.wav|specchio|mirror.wav
armario|closet|closet.wav|schrank|schrank.wav|placard|closet.wav|armadio|closet.wav
reloj|clock|clock.wav|uhr|uhr.wav|horloge|clock.wav|orologio|clock.wav
television|television|television.wav|fernseher|fernseher.wav|television|television.wav|televisione|television.wav
radio|radio|radio.wav|radio|radioa.wav|radio|radio.wav|radio|radio.wav
computadora|computer|computer.wav|computer|computera.wav|ordinateur|computer.wav|computer|computer.wav
telefono|phone|phone.wav|telefon|telefon.wav|telephone|phone.wav|telefono|phone.wav
coche|car|car.wav|auto|auto.wav|voiture|car.wav|auto|car.wav
bicicleta|bicycle|bicycle.wav|fahrrad|fahrrad.wav|velo|bicycle.wav|bicicletta|bicycle.wav
autobus|bus|bus.wav|bus|busa.wav|bus|bus.wav|autobus|bus.wav
tren|train|train.wav|zug|zug.wav|train|train.wav|treno|train.wav
avion|airplane|airplane.wav|flugzeug|flugzeug.wav|avion|airplane.wav|aereo|airplane.wav
barco|boat|boat.wav|boot|boot.wav|bateau|boat.wav|barca|boat.wav
moto|motorcycle|motorcycle.wav|motorrad|motorrad.wav|moto|motorcycle.wav|moto|motorcycle.wav
hospital|hospital|hospital.wav|krankenhaus|krankenhaus.wav|hopital|hospital.wav|ospedale|hospital.wav
farmacia|pharmacy|pharmacy.wav|apotheke|apotheke.wav|pharmacie|pharmacy.wav|farmacia|pharmacy.wav
clinica|clinic|clinic.wav|klinik|klinik.wav|clinique|clinic.wav|clinica|clinic.wav
doctor|doctor|doctor.wav|arzt|arzt.wav|docteur|doctor.wav|dottore|doctor.wav
enfermera|nurse|nurse.wav|krankenschwester|krankenschwester.wav|infirmiere|nurse.wav|infermiere|nurse.wav
paciente|patient|patient.wav|patient|patienta.wav|patient|patient.wav|paziente|patient.wav
medicina|medicine|medicine.wav|medizin|medicine.wav|medicament|medicine.wav|medicina|medicine.wav
pastilla|pill|pill.wav|pille|pille.wav|pilule|pill.wav|pillola|pill.wav
inyeccion|injection|injection.wav|injektion|injektion.wav|injection|injection.wav|iniezione|injection.wav
receta|prescription|prescription.wav|rezept|rezept.wav|ordonnance|prescription.wav|ricetta|prescription.wav
